....................#......#..#..##.##..#......#.......#..#.
........................##.##.....#.##......##.##.##.....##.
.....................#...#.#.....##.##....#...#.#......#..#.
.......................###.##...###.##......###.##..###.##..
.......................#....#....##.##....#....#......#.....
.......................#.........#....#.....#.....##.....##.
.....................##..##.#...###.##...##..##.#......#..#.
............................#...........###.##..#..#...#.#..
......................##..#.#......###.##......##.....#.....
.....................##.###.....##.##....#.#.##....#...#.#..
....................#.........#........###..#..#..##.....##.
........................##.##.....##.##...#.#.##.......#..#.
.....................#...#.#....#....###.##...#.#.##.....##.
.......................###........###....###.##.##....#.....
.......................#....#...#.......###..#.#...#.....#..
.......................#....#.....#...###.##...........#..#.
.....................##..##....##..##...#.#.##..#...###.##..
............................#.....###.#.........#..#..#..#..
......................##..#.#..........#.#.##..##..##....#..
.....................##.###.....##....##..##.##....#...#.#..
