..#....#..#..##.##......................#......#.......#..#.
....##.##.....#.##.#........................##.##.##.....##.
.#...#.#.....##.##........................#...#.#......#..#.
...###.##...###.##.#........................###.##..###.##..
...#....#....##.##........................#....#......#.....
...#....#....#....#.........................#.....##.....##.
.##..##.#...###.##......................##..#.#.#......#..#.
........#...............................#.#.##..#..#...#.#..
..##..#.#..#...###............................##......#.....
##.###.....##.##...#........................................
#.........#........#....................#...#..#..##.....##.
....##.##.....##.#........................#.#.##.......#..#.
.#...#.#....#....#.#.....................##...#.#.##.....##.
...###........###.........................##.##.##....#.....
...#....#...#......#....................##...#.#...#.....#..
...#....#.....#.........................#..#...........#..#.
.##..##....##..##..#....................#.#.##..#...###.##..
........#.....###...............................#..#..#..#..
..##..#.#..........#.....................#.##..##..##....#..
.##.###.....##...#........................##.##....#...#.#..