..............................................................
.....................#......#..#..##.##..#......#.......#..#..
.........................##.##.....#.##......##.##.##.....##..
......................#...#.#.....##.##....#...#.#......#..#..
........................###.##...###.##......###.##..###.##...
........................#....#....##.##....#....#......#......
........................#.........#....#.....#.....##.....##..
......................##..##.#...###.##...##..##.#......#..#..
.............................#...........###.##..#..#...#.#...
.......................##..#.#......###.##......##.....#......
......................##.###.....##.##....#.#.##....#...#.#...
.....................#.........#........###..#..#..##.....##..
.........................##.##.....##.##...#.#.##.......#..#..
......................#...#.#....#....###.##...#.#.##.....##..
........................###........###....###.##.##....#......
........................#....#...#.......###..#.#...#.....#...
........................#....#.....#...###.##...........#..#..
......................##..##....##..##...#.#.##..#...###.##...
.............................#.....###.#.........#..#..#..#...
.......................##..#.#..........#.#.##..##..##....#...
......................##.###.....##....##..##.##....#...#.#...
..............................................................