..................................................................................
.....................#......#..#..##.##..#......#.......#..#...##.##....#...#.#...
.........................##.##.....#.##......##.##.##.....##..#.##..##..##....#...
......................#...#.#.....##.##....#...#.#......#..#.........#..#..#..#...
........................###.##...###.##......###.##..###.##..#.#.##..#...###.##...
........................#....#....##.##....#....#......#.....#.##...........#..#..
........................#.........#....#.....#.....##.....##.###..#.#...#.....#...
......................##..##.#...###.##...##..##.#......#..#..###.##.##....#......
.............................#...........###.##..#..#...#.#...##...#.#.##.....##..
.......................##..#.#......#####.......##.....#.......#.#.##.......#..#..
......................##.###.....##.##....#.#.##....#...#.#..##..#..#..##.....##..
.....................#.........#..........#..#..#..##.....##..#.#.##....#...#.#...
.........................##.##.....##.##...#.#.##.......#..#.#......##.....#......
......................#...#.#....#....###.##...#.#.##.....##.###.##..#..#...#.#...
........................###........###....###.##.##....#......##..##.#......#..#..
........................#....#...#.......###..#.#...#............#.....##.....##..
........................#....#.....#...###.##...........#..#...#....#......#......
......................##..##....##..##.#.#.#.##..#...###.##......###..#..##..##...
.............................#.....###.#.........#..#..#..#....#.....#......#..#..
.......................##..#.#..........#.#.##..##..##....#......##.##.##.....##..
......................##.###.....##....##..##.##....#...#.#..#......#.......#..#..
..................................................................................