..##.##....#...#.#..
.#.##..##..##....#..
........#..#..#..#..
#.#.##..#...###.##..
#.##...........#..#.
###..#.#...#.....#..
.###.##.##....#.....
.##...#.#.##.....##.
..#.#.##.......#..#.
##..#..#..##.....##.
.#.#.##....#...#.#..
#......##.....#.....
###.##..#..#...#.#..
.##..##.#......#..#.
....#.....##.....##.
..#....#......#.....
....###..#..##..##..
..#.....#......#..#.
....##.##.##.....##.
#......#.......#..#.