#......#.......#..#.
....##.##.##.....##.
..#...#.#......#..#.
....###.##..###.##..
..#....#......#.....
....#.....##.....##.
.##..##.#......#..#.
###.##..#..#...#.#..
#......##.....#.....
.#.#.##....#...#.#..
##..#..#..##.....##.
..#.#.##.......#..#.
.##...#.#.##.....##.
.###.##.##....#.....
###..#.#...#.....#..
#.##...........#..#.
#.#.##..#...###.##..
........#..#..#..#..
.#.##..##..##....#..
..##.##....#...#.#..