#......#..#..##.##..#......#.......#..#.
....##.##.....#.##......##.##.##.....##.
.#...#.#.....##.##....#...#.#......#..#.
...###.##...###.##......###.##..###.##..
...#....#....##.##....#....#......#.....
...#.........#....#.....#.....##.....##.
.##..##.#...###.##...##..##.#......#..#.
........#...........###.##..#..#...#.#..
..##..#.#......###.#.......##.....#.....
.##.###.....##.##....#.#.##....#...#.#..
#.........#.........##..#..#..##.....##.
....##.##.....##.##...#.#.##.......#..#.
.#...#.#....#....###.##...#.#.##.....##.
...###........###....###.##.##....#.....
...#....#...#.......###..#.#...#.....#..
...#....#.....#...###.##...........#..#.
.##..##....##..##.#.#.#.##..#...###.##..
........#.....###.#.........#..#..#..#..
..##..#.#..........#.#.##..##..##....#..
.##.###.....##....##..##.##....#...#.#..