..........
...######.
.......A#.
...######.
...#....#.
...#....#.
........#.
..........
.........Z
..........
