..........
...######.
.......A#.
...######.
...#....#.
...#....#.
........##
........#Z
........#.
..........
