A......................#.........#.....#.
.#.#.#.#...#.#....###...###..#.#.###.#...
.......#.#...#.#.....#.....#.#.#.....#...
.#.#..##.#.#..##.#.##.#.##.....#####..###
.......#.#...#...#.......#...#.#.....#...
.#.#####.###.#.##..#...#.##..#.##.##.#.##
.#.#.....#...#.......#.#.#...#.......#...
.##...###..#.#.#.#.##....#.#...#.#.###.#.
...#.......#...#.#...#.....#...#.#.....#.
...#.#.##..#.#.#.##..#.#..####.#.###.#.#.
.....#...#...#...#...#.#.#.....#...#.#...
..#.###..#.#.#..#..###.#.#.#####.##......
.#...............#.#.#.#.#...............
.#.#.##.##.#.#.##..#.#.#####.#####.#.#.#.
.....#.............#.#.....#.....#.#.#.#.
##.##.##...###.#####.#.#.#..####.#..##..#
...................#.....#.............#.
..####...#...##..#.#.###############.##..
.............#...#.....#..........Z#.....
.#..###.##.#.###.#...#.#.##..#.###.####.#
...#...#...#.....#.......................
.#...#.#.##..#.....#####.#.##..#.###.#.##
...#.#.#.....#.#.#...#...#.#.#.#.........
.#...#.#####.....###..##.#.#...###.#..##.
...................#.....#.#.......#...#.
.#########.#####.##....###.#...###.#.#...
...........#.....#.......#.#.#...#.....#.


