....................#......#..#..##.##..#......#.......#..#...##.##....#...#.#..
........................##.##.....#.##......##.##.##.....##..#.##..##..##....#..
.....................#...#.#.....##.##....#...#.#......#..#.........#..#..#..#..
.......................###.##...###.##......###.##..###.##..#.#.##..#...###.##..
.......................#....#....##.##....#....#......#.....#.##...........#..#.
.......................#.........#....#.....#.....##.....##.###..#.#...#.....#..
.....................##..##.#...###.##...##..##.#......#..#..###.##.##....#.....
............................#...........###.##..#..#...#.#...##...#.#.##.....##.
......................##..#.#......###.#.......##.....#.......#.#.##.......#..#.
.....................##.###.....##.##....#.#.##....#...#.#..##..#..#..##.....##.
....................#.........#.........##..#..#..##.....##..#.#.##....#...#.#..
........................##.##.....##.##...#.#.##.......#..#.#......##.....#.....
.....................#...#.#....#....###.##...#.#.##.....##.###.##..#..#...#.#..
.......................###........###....###.##.##....#......##..##.#......#..#.
.......................#....#...#.......###..#.#...#.....#......#.....##.....##.
.......................#....#.....#...###.##...........#..#...#....#......#.....
.....................##..##....##..##.#.#.#.##..#...###.##..A...###..#..##..##..
............................#.....###.#.........#..#..#..#....#.....#......#..#.
......................##..#.#..........#.#.##..##..##....#......##.##.##.....##.
.....................##.###.....##....##..##.##....#...#.#..#......#.......#..#Z
