.......................#.........#.....
.#.#.#.#...#.#....###...###..#.#.###.#.
.......#.#...#.#.....#.....#.#.#.....#.
.#.#..##.#.#..##.#.##.#.##.....#####..#
.......#.#...#...#.......#...#.#.....#.
.#.#####.###.#.##..#...#.##..#.##.##.#.
.#.#.....#...#.......#.#.#...#.......#.
.##...###..#.#.#.#.##....#.#...#.#.###.
...#.......#...#.#...#.....#...#.#.....
...#.#.##..#.#.#.##..#.#..####.#.###.#.
.....#...#...#...#...#.#.#.....#...#.#.
..#.###..#.#.#..#..###.#.#....##.##....
.#...............#.#.#.#.#.............
.#.#.##.##.#.#.##..#.#.......#####.#.#.